NO ./textures/brick_wall.xpm
SO ./textures/sand.xpm
WE ./textures/wood.xpm
EA ./textures/wall.xpm

F 200,200,200
C 100,100,255

     1111111111111111111111111
     1000000000011000000000001
     1011000001110000000000001
     1100000000000000000000111111111
11111111011000001110000000000001
100000000011000001110111111111111
11110111111111011100000010001
11110111111111011101010010001
11000000110101011100000010001
10000000000000001100000010001
1000000000N000001101010010001
110000011101010111110111100111
11110111 1110101 1011110100001
11111111 1111111 111111111111